1111111111111111111111111111111111111111111111111111111111111111111111111111111111111111
1111111111111111111111111111111111111111111111111111111111111111111111111111111111111111
1000000000000000000000000000000000000000000000000000000000000000000000000000000000000001
1000000000000000000000000000000000000000000000000000000000000000000000000000000000000001
1000000000000000000000000000000000000000000000000000000000000000000000000000000000000001
1000000000000000000000000000000000000000000000000000000000000000000000000000000000000001
1000000000000000000000000000000000000000000000000000000000000000000000000000000000000001
1000000000000000000000000011110000000000000111110000000000000000001111100000000000000001
1000000000000000111100000000000000000000000000000000000000000000000000000000000000000001
1000000011110000000000000000000000000000000000000011111111111111111111111111100000000001
1000000000000000000000000000000011100000000000000000000000000000000000000000000000000011
1000000000000000000000000000000000000000000000000000000000000000000000000000000000000001
1000000000000000000000000000000000000110000000000000000000000000000000000000000000000001
1000000000000000000000000000000000000000000000111000000000000000000000000000000000000001
1000000000000000000000000000000000000000111000000000000000000000000000000000000000000001
1000000000000000000000000000000000111000000000000000000000000000000000000000000000000001
1000000000000000000000000000111000000000000000000000000000000000000000000000000000000001
1000000000000000000000111000000000000000000000000000000000000000000000000000000000000001
1000000000000000111000000000000000000000000000000000000000000000000000000000000000000001
1000000000111000000000000000000000000000000000000000000000000000000000000000000000000001
1000111000000000000000000000000000000000000000000000000000000000000000000000000000000001
1111111111111111111111111111111111111111111111111111111111111111111111111111111111111111